as - как
I - я
his - его
that - что 
he - он
was - был
for - для
on - на
are - являются
with - с
they - они
be - быть
at - на
one - один
have - иметь
this - это
from - из
by - от
hot - горячий 
word - слово
but - но
what - что
some - некоторый
is - является
it - это
you - ты
or - или
had - имел
of - из 
to - в 
and - и
in - в
we - мы
can - может
out - из 
other - другой
were - были
which - который
do - делать
their - их
time - время
if - если
will - будет
how - как
said - говорить
each - каждый
tell - говорить
does - делает
set - задавать 
three - три
want - хотеть
air - воздух
well - хорошо
also - также
play - играть
small - маленький
end - конец
put - ставить
home - дом
read - читать
hand - рука
port - порт
large - большой
spell - читать по буквам 
add - добавлять
even - даже
land - земля
here - здесь
must - должен
big - большой
high - высокий
such - такой
follow - следовать
act - действовать
why - почему
ask - спрашивать
men - люди
change - менять
went - отправился
light - свет 
kind - добрый 
off - от 
need - необходимость
house - дом
picture - картина 
try - пробовать 
us - нас
again - снова
animal - животное
point - точка
mother - мать
world - мир
near - близко
build - строить
self - себя
earth - земля
father - отец
any - любой
new - новый
work - работа
part - часть
take - брать
get - получать
place - место
made - сделать
live - жить
where - где
after - после
back - назад
little - немного
only - только
round - круглый 
man - мужчина
year - год
came - пришел
show - показывать
every - каждый
good - хороший
me - мне
give - давать
our - наш
under - под
name - имя
very - очень
through - через
just - только 
form - вид, форма 
sentence - предложение
great - отличный
think - думать
say - говорить
help - помогать, помощь
low - низкий
line - линия, черта
differ - отличаться
turn - поворачивать
cause - причина
much - много
mean - значить 
before - до
move - двигать
right - право 
boy - мальчик
old - старый
too - тоже
same - также
she - она
all - все
there - там
when - когда
up - вверх 
use - использовать
your - твой
way - путь
about - о
many - много
then - затем
them - их
write - писать
would - бы 
like - нравиться
so - так
these - эти
her - ее
long - долго 
make - делать
thing - вещь
see - видеть
him - его
two - два 
has - имеет
look - смотреть 
more - больше
day - день
could - мог
go - идти
come - приходить
did - сделал
number - номер
sound - звук
no - нет
most - самый 
people - люди
my - мой
over - над
know - знать
water - вода
than - чем
call - звонить 
first - первый
who - кто
may - может
down - вниз
side - сторона
been - был
now - сейчас
find - найти
head - голова
stand - стоять
own - свой 
page - страница
should - должен
country - страна
found - найденный
answer - ответ 
school - школа
grow - расти
study - изучать
still - все еще
learn - учиться
plant - растение 
cover - накрывать 
food - еда
sun - солнце
four - четыре
between - между
state - состояние, государство, штат
keep - держать, продолжать
eye - глаз
never - никогда
last - последний
let - позволять
thought - мысль 
city - город
tree - дерево
cross - пересекать 
farm - ферма
hard - тяжелый 
start - начинать
might - может быть 
story - история
saw - увидел 
far - далеко
sea - море
draw - рисовать
left - лево 
late - поздно
run - бежать
don’t - не
while - в то время, как
press - нажимать 
close - близко 
night - ночь
real - реальный
life - жизнь
few - несколько
north - север
book - книга
carry - нести
took - взял
science - наука
eat - есть
room - комната
friend - друг
began - началось
idea - идея
fish - рыба
mountain - гора
stop - остановка 
once - однажды
base - базовый 
hear - слышать
horse - лошадь
cut - резать
sure - конечно 
watch - смотреть 
colour - цвет
face - лицо
wood - дерево
main - главный
open - открыть
seem - казаться
together - вместе
next - следующий
white - белый
children - дети
begin - начинать
got - получил
walk - гулять 
example - пример
ease - легкость 
paper - бумага
group - группа
always - всегда
music - музыка
those - те
both - оба
mark - отметка 
often - часто
letter - письмо
until - до тех пор
mile - миля
river - река
car - машина
feet - ноги
care - заботиться 
second - секунда
enough - достаточно 
plain - простой
girl - девочка
usual - обычно
young - молодой
ready - готовый
above - выше
ever - когда-либо
red - красный
list - список
though - хоть
feel - чувствовать
talk - говорить
bird - птица
soon - скоро
body - тело
dog - собака
family - семья
direct - непосредственный 
pose - поза 
leave - покидать
song - песня
measure - мера 
door - дверь
product - продукт
black - черный
short - короткий
numeral - числительное
class - класс 
wind - ветер
question - вопрос
happen - случаться
complete - полный 
ship - корабль
area - площадь 
half - половина
rock - рок 
order - заказ 
fire - огонь
south - юг
problem - проблема
piece - часть 
told - говорил
knew - знал
pass - проходить 
since - с 
top - верх 
whole - весь 
king - король
street - улица
inch - дюйм
multiply - умножать
nothing - ничего
course - курс 
stay - оставаться
wheel - колесо
full - полный
force - сила 
blue - голубой 
object - объект
decide - решать
surface - поверхность
deep - глубоко
moon - луна
island - остров
foot - нога
system - система
busy - занят
test - тест 
record - записывать
boat - лодка
common - общий 
gold - золото
possible - возможный
plane - самолет 
stead - место
dry - сухой
wonder - чудо 
laugh - смех 
thousand - тысяча
ago - тому назад
ran - побежал
check - проверять
game - игра
shape - форма
equate - приравнивать
OK - хорошо
miss - скучать 
brought - привел
heat - жара, высокая температура
snow - снег
tire - шина 
bring - приносить
yes - да
distant - отдаленный
fill - наполнять
east - восток
paint - краска 
language - язык
among - среди
unit - единица
power - мощность 
town - город
fine - отлично
certain - определенный
fly - летать
fall - падать 
lead - вести 
cry - плакать
dark - темный, темнота
machine - машина 
note - примечание 
wait - ждать
plan - план
figure - цифра 
star - звезда
box - коробка
noun - существительное
field - поле
rest - остальное 
correct - поправлять 
able - в состоянии 
pound - фунт
done - сделанный
beauty - красота
drive - водить
stood - стоял
contain - содержать
front - перед
teach - обучать
week - неделя
final - финал 
gave - дал
green - зеленый
oh - ох
quick - быстро
develop - развивать
ocean - океан
warm - тепло
free - свободный
minute - минута
strong - сильный
special - особый
mind - разум 
behind - позади
clear - ясный 
tail - хвост
produce - производить
fact - факт
space - пространство 
heard - слышал
best - лучший
hour - час
better - лучше
true - правда
during - в течение
hundred - сотня
five - пять
remember - помнить
step - шаг
early - ранний 
hold - держать
west - запад
ground - земля
interest - интерес
reach - достигать
fast - быстро
verb - глагол
sing - петь
listen - слушать
six - шесть
table - стол
travel - путешествовать
less - меньше
morning - утро
ten - десять
simple - просто 
several - несколько
vowel - гласный 
towards - к 
war - война
lay - лежать
against - против
pattern - узор
slow - медленно 
center - центр
love - любовь
person - человек
money - деньги
serve - обслуживать
appear - появляться
road - дорога
map - карта
rain - дождь
rule - правило
govern - управлять
pull - тянуть
cold - холодный
notice - уведомление 
voice - голос
energy - энергия
hunt - охотититься
probable - вероятный
bed - кровать
brother - брат
egg - яйцо
ride - ездить 
cell - клетка 
believe - верить
perhaps - возможно
pick - выбирать
sudden - внезапный
count - считать
square - квадрат 
reason - причина
length - длина
represent - представлять
art - искусство
subject - предмет
region - регион
size - размер
vary - меняться 
settle - селиться
speak - говорить
weight - вес
general - главный 
ice - лед
matter - иметь значение 
circle - круг
pair - пара
include - включать в себя
divide - разделять
syllable - слог
felt - чувствовал
grand - большой 
ball - мяч
yet - еще
wave - волна
drop - капля 
heart - сердце
AM - до полудня
present - подарок 
heavy - тяжелый
dance - танец 
engine - двигатель
position - позиция
arm - рука
wide - широкий 
sail - паруса 
material - материал
fraction - доля
forest - лес
sit - сидеть
race - гонка 
window - окно
store - магазин
summer - лето
train - поезд
sleep - спать
prove - доказывать
alone - один 
leg - нога
exercise - упражнение
wall - стена
catch - поймать
mount - взбираться 
wish - желать
sky - небо
board - доска
joy - радость
winter - зима
somebody - кто-то
written - написанный
wild - дикий
instrument - инструмент
kept - сохранил
glass - стекло
grass - трава
cow - корова
job - работа
edge - край
sign - подписывать 
visit - посещать
past - прошлое
soft - мягкий
fun - веселый 
bright - яркий
gas - газ 
weather - погода
month - месяц
million - миллион
bear - медведь 
finish - закончить
happy - счастливый
hope - надежда 
flower - цветок
clothes - одежда
strange - странный
gone - ушедший
trade - торговля
melody - мелодия
trip - поездка
office - офис
receive - получать
row - ряд
mouth - рот
exact - точный
symbol - символ
die - умирать
least - наименее 
trouble - проблема
shout - кричать
except - кроме 
writer - писатель
seed - семя
tone - тон
join - присоединяться
suggest - предлагать
clean - чисто 
break - перерыв 
lady - леди
yard - двор
rise - рост 
bad - плохой
blow - удар 
oil - масло
blood - кровь
touch - трогать 
goal - цель
cent - цент
mix - смесь 
team - команда
wire - проволока
cost - стоимость
lost - потерял 
brown - коричневый
wear - носить
garden - сад
equal - равный
sent - отправил 
choose - выбирать
feel - чувствовать
fit - соответствовать 
flow - поток 
fair - ярмарка 
bank - банк
collect - собирать
save - сохранять
control - контроль 
decimal - десятичный
ear - ухо
else - еще
quite - довольно
broke - сломал 
case - случай
middle - средний
kill - убивать
son - сын
lake - озеро
moment - момент
scale - шкала
loud - громко
spring - весна
observe - наблюдать
child - ребенок
straight - прямо 
consonant - согласный
nation - нация
dictionary - словарь
milk - молоко
speed - скорость
method - метод
organ - орган
pay - платить
age - возраст
section - раздел
dress - платье 
cloud - облако
surprise - сюрприз
quiet - тихо 
stone - камень
tiny - крошечный
climb - подъем 
cool - крутой 
design - дизайн
poor - бедный
lot - много
explain - объяснять
bottom - низ
key - ключ
iron - железо
single - один
stick - придерживаться 
flat - квартира 
twenty - двадцать
skin - кожа
smile - улыбка
crease - складка 
hole - дыра
jump - прыгать
baby - ребенок
eight - восемь
village - деревня
meet - встречать
root - корень
buy - покупать
raise - поднимать 
solve - решать
metal - металл
whether - будь то 
push - давить 
seven - семь
paragraph - параграф
third - третий
shall - должен
held - держал
hair - волосы
describe - описывать
cook - готовить
floor - пол
either - или
result - результат
burn - гореть 
hill - холм
safe - безопасный
cat - кот 
century - век 
consider - рассматривать
type - тип 
law - закон
bit - немного 
coast - берег
copy - копировать 
phrase - фраза 
silent - тихий
tall - высокий
sand - песок
soil - почва
roll - вертеть
temperature - температура
finger - палец
industry - индустрия
value - значение 
fight - драка 
lie - ложь 
beat - бить 
excite - возбуждать
natural - натуральный
view - вид
sense - смысл 
capital - столица
won’t - не будет
chair - стул
danger - опасность
fruit - фрукт
rich - богатый
thick - толстый
soldier - солдат
process - процесс 
operate - управлять
practice - практиковать 
separate - разделять
difficult - сложный
doctor - доктор
please - пожалуйста 
protect - защищать
noon - полдень
crop - обрезать 
modern - современный
element - элемент
hit - удар 
student - студент
corner - угол
party - вечеринка 
supply - поставка 
whose - чьи
locate - размещать
ring - кольцо
character - персонаж 
insect - насекомое
caught - поймал 
period - период 
indicate - указывать
radio - радио
spoke - говорил
atom - атом
human - человек
history - история
effect - эффект 
electric - электрический
expect - ожидать
bone - кость
rail - рельс 
imagine - представлять
provide - предоставлять
agree - соглашаться
thus - таким образом
gentle - нежный
woman - женщина
captain - капитан
guess - предположение 
necessary - необходимый
sharp - острый 
wing - крыло
create - создавать
neighbour - сосед
wash - мыть
bat - летучая мышь 
rather - скорее
crowd - толпа
corn - кукуруза
compare - сравнивать
poem - стих
string - струна
bell - колокол
depend - зависеть
meat - мясо
rub - тереть
tube - трубка 
famous - известный
dollar - доллар
stream - поток 
fear - страх 
sight - взгляд 
thin - тонкий
triangle - треугольник
planet - планета
hurry - торопиться 
chief - шеф
colony - колония
clock - часы
mine - мой
tie - галстук 
enter - вход 
major - майор 
fresh - свежий
search - поиск 
send - посылать
yellow - желтый
gun - пистолет 
allow - позволять
print - печать 
dead - мертвый
spot - место 
desert - пустыня
suit - костюм 
current - текущий
lift - поднимать 
rose - роза
arrive - прибывать
master - мастер 
track - трек 
parent - родитель
shore - побережье
division - деление
sheet - лист 
substance - вещество
favour - одолжение
connect - соединять
post - почта 
spend - тратить
chord - аккорд
fat - жир 
glad - рад
original - оригинальный
share - делиться
station - станция
dad - папа
bread - хлеб
charge - заряд 
proper - правильный
bar - бар
offer - предлагать 
segment - часть 
slave - раб
duck - утка
instant - мгновенный
market - рынок
degree - температура
populate - населять
education - образование
dear - дорогая
enemy - враг
reply - ответ 
drink - напиток 
occur - происходить
support - поддержка 
speech - речь
nature - природа
range - диапазон
steam - пар
motion - движение
path - путь
liquid - жидкость
violence - жестокость
meant - значил
quotient - частное
teeth - зубы
shell - ракушка
neck - шея
oxygen - кислород
sugar - сахар
death - смерть
pretty - красивый 
skill - умение
women - женщины
season - сезон 
solution - решение
magnet - магнит
silver - серебро
thanks - спасибо
lunch - ужин
match - совпадать 
treat - угощение 
especially - особенно
fail - провал 
afraid - испуганный
huge - огромный
sister - сестра
steel - сталь
discuss - обсуждать
forward - вперед
similar - похожий
guide - руководство 
experience - опыт
score - очки 
apple - яблоко
evidence - доказательства
message - сообщение
movie - фильм 
coat - пальто
mass - масса
card - карта
band - группа
rope - веревка
slip - скользить
win - побеждать
dream - мечта 
evening - вечер
condition - состояние
feed - кормить
tool - инструмент
total - сумма
basic - базовый
smell - запах
valley - долина
not - не
double - двойной 
seat - место
continue - продолжать
news - новости
police - полиция
hat - шляпа
sell - продавать
success - успех
company - компания
security - безопасность 
event - событие
particular - особенный 
deal - сделка 
swim - плавать
term - срок 
opposite - напротив 
wife - жена
shoes - обувь 
shoulders - плечи
spread - распространение 
arrange - организовывать
camp - лагерь
invent - изобретать
cotton - хлопок
born - родиться
determine - определять
quarter - четверть
nine - девять
remove - удалять
noise - шум
level - уровень
chance - шанс
gather - собирать
shop - магазин 
stretch - растягивать
throw - бросать
shine - сиять
property - собственность
issue - проблема
legal - законный
select - выбирать
wrong - неправильный
gray - серый
repeat - повторять
require - требоваться
broad - широкий
prepare - подготавливать
salt - соль 
nose - нос
plural - множественное число
anger - гнев
claim - запрос 
price - цена
