home - дом
read - читать
hand - рука
port - порт
large - большой
spell - читать по буквам 
add - добавлять
even - даже
land - земля
here - здесь
must - должен
big - большой
high - высокий
such - такой
follow - следовать
act - действовать
why - почему
ask - спрашивать
men - люди
change - менять
went - отправился
light - свет 
kind - добрый 
off - от 
need - необходимость
house - дом
picture - картина 
try - пробовать 
us - нас
again - снова
animal - животное
point - точка
mother - мать
world - мир
near - близко
build - строить
self - себя
earth - земля
father - отец
any - любой
new - новый
work - работа
part - часть
take - брать
get - получать
place - место
made - сделать
live - жить
where - где
after - после
back - назад
little - немного
only - только
round - круглый 
man - мужчина
year - год
came - пришел
show - показывать
every - каждый
good - хороший
me - мне
give - давать
our - наш
under - под
name - имя
very - очень
through - через
just - только 
form - вид, форма 
sentence - предложение
great - отличный
think - думать
say - говорить
help - помогать, помощь
low - низкий
line - линия, черта
differ - отличаться
turn - поворачивать
cause - причина
much - много
mean - значить 
before - до
move - двигать
right - право 
boy - мальчик
old - старый
too - тоже
same - также
she - она
all - все
there - там
when - когда
up - вверх 
use - использовать
your - твой
way - путь
about - о
many - много
then - затем
them - их
write - писать
would - бы 
like - нравиться
so - так
these - эти
her - ее
long - долго 
make - делать
thing - вещь
see - видеть
him - его
two - два 
has - имеет
look - смотреть 
more - больше
day - день
could - мог
go - идти
come - приходить
did - сделал
number - номер
sound - звук
no - нет
most - самый 
people - люди
my - мой
over - над
know - знать
water - вода
than - чем
call - звонить 
first - первый
who - кто
may - может
down - вниз
side - сторона
been - был
now - сейчас
find - найти
head - голова
stand - стоять
own - свой 
page - страница
should - должен
country - страна
found - найденный
answer - ответ 
school - школа
grow - расти
study - изучать
still - все еще
learn - учиться
plant - растение 
cover - накрывать 
food - еда
sun - солнце
four - четыре
between - между
state - состояние, государство, штат
keep - держать, продолжать
eye - глаз
never - никогда
last - последний
let - позволять
thought - мысль 
city - город
tree - дерево
cross - пересекать 
farm - ферма
hard - тяжелый 
start - начинать
might - может быть 
story - история
saw - увидел 
far - далеко
sea - море
draw - рисовать
left - лево 
late - поздно
run - бежать
don’t - не
while - в то время, как
press - нажимать 
close - близко 
night - ночь
real - реальный
life - жизнь
few - несколько
north - север
book - книга
carry - нести
took - взял
science - наука
eat - есть
room - комната
friend - друг
began - началось
idea - идея
fish - рыба
mountain - гора
stop - остановка 
once - однажды
base - базовый 
hear - слышать
horse - лошадь
cut - резать
sure - конечно 
watch - смотреть 